english	urdu
u.n.	تکلیف نگرانی غم ہتک خوف ترد
draft	فتحت نوٹ پیشکش تصحیح
plan	تھکانا تھکا تھکاوٹ تھک
to	تک تکے
reduce	کمی کم کمیاب
the	یہ یہہ
u.n.-sponsored	تلاش فاید مساعدت امداد تر
climate	تھکاوٹ ہوا موسم
conference	ملاقات اجلاس پرستی مبارز
characterize	خصوصیت خصوص
so	سو
far	فار
by	کو سے پر نے کی کے
unruly	مضبوط بے نظم
posturing	تھا ست وضو حالات مقام
recrimination	تادیدی اظہار توبیخ
gain	فا دہ کسب کمزوری کامیابی
renew	بازیافت
focus	مرکزی نظر حلقہ انتقال
friday	جمعہ
with	فرا
of	ہو کے سے پر کی
a	ایک واحد واحدہ
document	فہرست کاغذ دستخط مستند
outline	فریم خط نقشہ چڑھایا
ambitious	تعبہ یہ عروج تلاش
greenhouse-gas	گیس خطرہ
over	تلے سے پہلے
next	لاح عدم اگلی بعد گے
year	سال محاسب زمانہ مفلوک
industrialize	توسعت دار صنایع
nation	قوم
shoulder	کندہ بال بازو
most	ست
burden	وزیرانہ دعاوی خوار بوجھ بگھار
near	نار
term	توقع شرط محدودیت محد
.	خوش دلخوش
text	تکست
which	جو کیسے کہ
could	دی
provide	توفید کرنا تعبدیل
political	تعبدی سیاسی اداروی مصلح
deal	دل لدل
regulate	کنٹرول کریں نظام ضبط رام رکھیں
greenhouse_gas	کیونکہ ہوا میں گیس
highlight	تھکانا
obstacle	دا وردہ
as	کواس
it	یہ ہاں اس یہا ہو
illuminate	دینا
path	پھوڑا درخوست مسیر تارہ تلوار
see	نظریں دیکھیں جیکے
important	اہم
advance	قدم پیشرفت مقدمہ
negotiation	تہذیب گفتگو مفاہمت
that	تھا تھی ہو
out	تے
more	زیادہ
than	تک
100	تاسع عشر
world	دنیا
leader	رہنما
arrive	نا پہنچنا درکار
copenhagen	کپنھ من
week	ہفتہ
forge	فروغ
ad-hoc	در
working_group	شاوڑا گروپ
silent	سلامت سکوت خاموش رام تیار
how	کیسے کیوں کسا
rich	ثروتمند
would	کارت کرے گا
poor	فقیر
one	ایک
cope	کامیاب توجہ تکمیل
global_warming	گلوبال وارمنگ
short	سبہ کوتاہ چھوٹا
long	لا طویل اچھا مستقل مضبوط
range	رنج پیدہ پہنچ
option	پشن امکان فرصت انتخاب
key	مفتاح چابیاں قفل
question	سوال
major	وڑ اہم بڑا اہمیت
emerge	فروغ ظہور پیدا ظاہر
economy	اقتصادی
they	وہ انہی
output	نتا نتیجہ فرخوش
what	کیا کیسے کون کونہ
global	جاتی عالمی
temperature	تھرم سخت درجہ تبدیل
rise	فرو ار ارتقا تک
policymaker	فاروس سیاست مدار ناظم
tolerate	تلافی تہہنہیں تحمل تکبر
lot	لوٹ
flexibility	انور لچک توجہ تکمیل
process	فعل کار عمل روش
say	کہنا بولنا
john	جون
coequyt	توازن مساوات
senior	انسانی عمر پرانی
washington	واشنگٹن
representative	ارعاز ین
sierra	سیرعا
club	چابک چمک چوٹی چور
michael	محمد عمر راشد
zammit	زمیٹ
who	کیو
six-page	تیرہ صفحہ
boil	پھیل
180-page	پر صفحات
top	ٹھپ
official	فرمانیہ ہدایتگار امینی مس ول
yvo	یاد ھی یادگار یادشوق
boer	توبہ توب
describe	فرضی تصریح وضوح اظہار وضاحت
big	بڑا
picture	صور تصویر عکس
show	دیکھنا نظرانداز کرنا پیشکش
possible	امکان مستقل مذہول موجہ
industrial	تھکاوارا صنعتی
collectively	جگتہ ایکجا جات
25	دل دلکا دلاب
percent	فقط الفاظ
level	سلسلہ متناہی مساوی سط
while	کھیلی ہو تھی جیسے ہوا
developing_country	تک دیکھ رکھنے والی کشور
theirs	تھا تھے
during	یادداشت کے درمیان
period	فصل موسم دورانیہ زمانہ
15	واحد
30	تینتیس
together	ایک ساتھ
between	تیرہ
50	جنب
european_union	یورپی اتحاد
talk	مرکزی بات گفتگو تبلیغ
boost	تکمیل کریں کرنا بہتر
well	وعد سخت خوب صحت
pledge	قسم وعدہ بیان
3.6	ست تین
billion	لا کروڑ
help	مرکوز
poorer	تعبہ
impact	ثیر
climate_change	تغ ہوا
from	فراہم کرنا لینے نا جیس
flood	فروغ سیلاب سیل تپاں
drought	شابی سی سیزی ہمارا ہو
avoid	تارک
still	سلامت ٹھیک مستقیم سست محدود
feature	فرماں روا خصوصیت نمایاں کرد
sort	مرتب سار ترتیب
verbal	تعبیر گفتگو لفظی بات
firework	رج چمک پہاڑ
have	ہو
past	تک
u.s.	امریکہ
special	تخصصی مختص فردی اہم متم
envoy	جاریہ مبعوث ممثلہ مشیر
todd	تڈ
stern	تعبہ سخت سختگرا سختدل
require	لازم احتیاج ضرورت مانا کرنا
binding	بھاوند جڑانا پیوستگی
industrialized	توسعت زدہ
voluntary	خلاصہ
if	اگر ہاں نہیں
not	نہیں
fund	فیڈ
move	چلنا انتقال انتقام ان
signal	معاینہ اشارہ ہمت علامت
obama	اوباما
take	لینا
hard_line	تعبدی سخت مصلح محد
china	چینی
bush_administration	حکومت بدنامی
do	نا
just	جسٹ
two	دو
united_states	امریکا
without	بد
step	کڑکی پا پیش قدمی روانہ
up	تکلیف موجود وجود موجودگی
action	کارروا عمل قابل
also	ھی بھی
complain	کلامی شکوا تذکرہ تکہن
enough	کاف
make	بنانا ساختہ خلق
verify	رنا
observer	نظرہ مشاہدہ دیکھنے والے مشاہدگار
comment	کومنٹ
hour	فوری منٹ ساعت دقیعت
after	بعد تکمیل کے
chinese	چینی
foreign_minister	فارین وزیر
america	امریکہ
negotiator	نچارجوکار
lack	کمبود
common_sense	کومن سے
or	مرکاز مربع چور
extremely	ایک بڑی درجہ کے
irresponsible	کذر عمل بےمس ولیتی نادہانی
earlier	تیزی سے لے
future	مستقبل
economic	اقتصادی
major_power	مقدرت ھرارتی طاقت
at	تا ہوا رہا تھا
stake	تھکاوٹ نکلنا مخاطرہ وقف
fault_line	فالٹ لا
erupt	فروڑ بھرپ بھاگڑا
within	دل میں داخل کے اندر درون
develop	تکمیل پرورش جذب سخت رشد
current	ہمارے ساری تکمیل ہوا
battle	جھاگ
about	بارے کرب کوشش موجود
save	احفظ کریں نجات صرف محفوظ رکھیں
individual	فرد
planet	زمین فضا نجست عالم فضاوسفر
feud	فرو
respective	مختص متعلق خاص
obligation	بیاں دعاوی مس ولیت فرض وا
two_dozen	دو
influential	ثیرگذار
ignore	کبھی نظر نہیں دینا
scientific	علمی
imperative	توجیہ کرارہ ہدایت امانتداری
bolder	شجاعت بہادری ہمدردی
ricardo	ریکارڈو
ulate	تلاش کرنا پیدا
costa	ست وجا
rican	ہنسی خوشی مضحک ندہ
delegate	تحدیف تفو امربھ نا
surprising	تارکدار دلچسب حیرت انگیز
fight	جھاگ جھڑ مبارزہ جنگ تر
cost	قیمت ہونا
curb	را شکلا محدود قابل
even	توازن متناہی ایکساں مسا
vulnerable	تکلیف ضعیف بےوقوف سان حساس
aggressive	تکلیففر حارث مخلوط مستبد
seek	تلاش کریں بحث در جستجو
hold	تھامنا جیدا پکڑے رکھنا فعل
this	یہ
game	لکھاب
where	کہاں
new	نو
regional	رج
mexico	کسیکو
central_america	مرکز مر
adviser	نصیح مشیر
conservation	تخ
international	تلاشیاتی تعاوناتی عالمی االملکی
some	بعض کو کمی کچھ ایک
indicate	تکمیل کریں اشارہ بیان نشان
push	زخم دفع دھکا دبا
legally	لگا قانون جزا
treaty	تی
although	حالا بھی اس کے باوجود یہ
participant	بر گاہ
will	کمیل نیت عزم قصد
produce	تولید تربوز توتھا
best	بہترین اچھی خوب برا
alliance	سلامی ریاستی اتحاد وفاقی
small	اصغر چھوٹی کو بیچڑھا
member	ہاتف
24-page	فوری
proposal	پیشکش نوید عرض پیشن اد
early	یاد وری صرف الفاظ فراہم کریں کو وضاحت نہیں
morning	صبحا رت
artur	رتور
behalf	عدالت فارسی تصدیق نام برے
european	یورپی
pressure	تکا رت اب
entire	مکمل
because	کون کیسے کونہ
now	ہونے والے
demand	تھ وھیں درخواست احتیاج کرچاہ
such	یہ یہاں تک سے
india	ہند بھارت
urgency	یت
fact	فیکت
must	ضروری جبانی کو ملنا
resolve	حل کریں جذبات کو قابو میں رکھیں منفیات
outstanding	فاروق براست مختص اعلی
government	حاکمیت
strike	تھا تکلیف
high-level	تلےدار چی قد
indian	تادم
environment	سماج جگاں محیط
minister	وزیر
off	کھارج باہر
plane	فرشتہ
race	ارع سپر متفاوت مخالف مبارز
through	تھک کر سے گزر گزرنا گزرتے ہو
bellum	جنگ قتال مبارزہ
center	مرکز
hall	ہال
meeting	اجٹ اتحاد ملاقات اتاش ات
news_conference	کانفرنس
claim	کاثر حق ادا دعوی استحق
sheer	خوبصورت ہوا یہ سخی
sprawl	پرتاب ہونا نا
gathering	جمع کرنا ہجوم ملاقات ایکدستگی
13,000	تیرہ ہزار
people	لوگ
convention	اصطلاح مذہب داب
each	ہر ایک
day	روزہ رات دن امروز کل شام
guitar-playing	را
activist	محاربی مدافع مناصر ملا
nightly	راوتر راتب رات شب راتانہ
mock	مضحک ہنسی پکارا جھکتا
think	تکنے سوچ فکر خیال
sell	امانی فروعات بیچنا فروخت
pass	تلاش مرور پاس
hand-to-hand	ملاقاتی مباشر ون تکتے
paper	کاغذ
rather	فقط الفاظ
via	سے کے ذریعے
e-mail	ایمیل
challenge	تحدی
intensity	تک
only	مفت فقط باقاعدہ
build	ناو سازشا تلوار بنا
:	خوش دل
nearly	نیازی تقریبا کمی سی تقریبی
all	تمہ سب ہر
here	یہاں
wednesday	ھفتھ جمعہ پھیروزہ
60	دل دلکلام خوشی مختصر
we	ہم
get	ہونا بننا پہنچنا پہونچنا
into	میں
big_league	بہ
carlo	کرلو
manuel	دست
vice_president	عدالت نا
policy	عدالت نظام سیاست حکومت قانون
heavyweight	وزیرانہ محکم بشمہ بڑا بڑے اہم
come	نا
baskonium	بسکومینیوم
away	جدا سے دور
victory	جیت شکریہ
caja	کاجا
laboral	لا
stunning	جمانے والی برا با چمکدار
visit	دید اتنا
maccabee	مکاوی
electra	الیکٹرہ
court	عدالت دادگا سیاستخانہ
despite	چپڑتے ہو
dusko	سک
ivanovic	ایوانوف
team	تیم
heavy	وزیرانہ بھاری کثیر اہم
loss	ہانا ناکامی خسارت
great	بہت ہمارا زیادہ کثیر اعلی
performance	عملکردہ کارکردہ عمل کار
mizra	مظہر
teltovic	تلفظ
eight	ٹھ
three-pointer	پوا نٹر
score	مرتبہ نقاط حاصل
29	تین
point	تکتے نقطہ مرکزی
)	جان دل روح
vitorian	فوریان
know	اجانے واستعمال دانہ علم دانشمند جاننا
significant	اہمیت مرکزی قابل توج اہم ضروری
absence	فقد محدودیت غیاب
herrmann	ہرم ان
oleson	ہو سکتا ہے یہ ایک غلط لفظ
huerta	ہزار
micov	میکو
dose	وز
involvement	مشار درمیان شار ضبوط
though	کبھی کاش
until	تک
end	ختم
additionally	مزید سے ابھی بھی
huge	بہا بڑا سخت کبڑا
sideline	ورانا رسہ رسی
16	خوش سعید
pointer	توجہ نشان اشارہ
favor	فایاد کرم احسان نعمت مہرب
azulgrana	رنگی سبز
themselves	خود سے
scoreboard	تعدادبر اسک برد
vitora	ٹورا
first	فہرست افتادگی
four	چار
basket	کوسا کڑا
perimeter	پراپرٹی چور حاڑہ چپہ
speculation	تخم لگانا فرض استقراء توقع
already	اور ہو چارہے شاید کاش
israeli	را یلی
net	نیٹ
hot	حار
wrist	دست زباں دستان چمنی
english	انگلش
teletovic	ویک
scorer	اسکورر راقم نگراں اسکورنگ
second	فوری دوسرا دوسرے دوس
quarter	تہا
alavan	تلاش فکر ال
opt	انتخاب
eliyahu	علی
greet	سلام کرنا جملہ جاتی ہو پکارنا
whistle	وس وا چھیل
applause	جملوں پر احترام تک پرخ
return	راجعہ بازگشت
home	دل خانہ گھر ہا اسپیس سکن
increase	اچھی زیادہ اعداد تکمیل
half-time	ہل
begin	شروع تکمیل غاز ختم
stand	تھا رہا ٹھہرایا
13	اش
splitter	مفلوق مفروض مفروضہ
six	روش تین چھ
fewer	کمی کم تعداد
n't	نہیں
night	رات دلگیر شب غم خاموش تار
brazilian	برازیلیانی
halftime	ہل
try	محلے کوشش امکان سعی
remind	یاد وری رکھنا
anybody	کسی بھی شخص
`	خوش
hand	لا ہاتھ
elia	علی
manage	عام دار
pninus	تکلیف نقصان خستہ وارہ مضبوط
decisive	تعب تصم قطعاع نمنٹ نرم
role	رو عمل کرام نصب
yellow	کالے رنگ ہرے سفید
light	روشنی چمک نور تلاش
disadvantage	دعاوت فا دہ معاوا نقصان
player	راقم کھلاڑی
injured	جروح پسی دروجہ
dead	مرتعدے
need	ھانچن احتیاج کرچ تعل
correctly	تا سچا صحیح
breathe	نن سا نفس نفسہ نفسان
marza	مرد مزاج
almost	یسا ہاں
consecutive	نتی نسیو
riba	با
bring	نے کو لا یں
narrow	تض محدود مبہم
third	تہا
57-67	امکان مستقل محدود
alava	علیبا
bone	ون
last	خر ختام پایانی خرا
emeterio	امیریو
clear	جلو جھلا صاف
let	کہنا
anyone	کسی بھی ایک کو ہر
earn	کسب جا زہ مد شجرہ دلہن
thirty	فرض ری پچیس تین
minute	مفصل تفصیلی دقیقی جز
however	ہاں لیکن
alive	جاندار زندہ موجود
three-point	پوا نٹ
line	لا
spite	تھاڑپ دلچسپ نفرت ہتک
foul	فول
ivonic	پشیل
rush	تکلیف اضطراب اندھا دھند سفر شتاب
close	وڑا درد ور قرب
last_minute	خر لحظے
tel	تعلل
aviv	اپ
season	فصل
wall_street	سڑک والہ
momentum	جاریگی تک
slow	کتاب
dollar	دل
new_york_stock_exchange	نیوی سٹاک ایکسچینج
no	جناب
particular	مخصوص فردی معین حص
heading	مر عنوان سرگزشت رکھاو
market	مرکت
tear	رکھو کھینچ پھتک
better	بہتر
expect	توقع
indicator	فیدابودار
dow_jones	ڈو جنز
0.63	جیسا ایک
%	مرکزی
drop	فیل تپ پڑا کرنا پہنچنا
0.03	تھیں
accord	تفقہ ہم ہنگی اتفاق
figure	فعل کار مخاطب شکل موجود
jone	جانے
average	توسط متوسط سختوسوسط
10	فارسی
471.5	مفلوغ
whereas	فرصہ تاہم اور جبکہ اس کیونکہ
technology	تکنالوجی
predominance	تک غالب غالبیت غالبہ
fall	فیل کرے پڑا گم ہوا
0.55	عدد
2	دو
wider	فردہ وسیع
standard	سادہ معمول معیار معتبر
&amp;	نہیں کبھی
500	قیمت
itself	خود اسے سے ہی
0.37	عدد
4.06	جواب چارہ چار
frankly	فریق
very	بہت
mace	ٹھا
blicksilver	لاکل سیاہی چمک سفید
marblehead	مربل ہیڈ
management	عام لت نظام ادارہ
narrow_margin	فہرست کو چھوٹا
trading	تجارت
volume	جلد حصہ حجم ادارہ ترازو
weak	فقدہ شدہ ضعیف کمزور لاحول لبیضاء
I	میں
case	حالت موقف صورت مسا
trend	فروغ سی موضوعدار
publication	برنامہ کیشن
opinion	دید گا کرمند راے نظر
robustness	بہ وری قوت مقاومت
recovery	تکمیل استفاقہ شفا
summarise	تخلیص صراحت تلخیص
analyst	انالیسٹ
retail	فا دہ فروخت بیع فروش
sale	فروش فروخت بیع معاوض
1.3	موقعیت
month	فروری مارچ اپریل
row	تارا ھوپ
predict	تنب پیش بینی استنباط توقع
moreover	مزید اور بھی
confidence	فا
american	امریکہ
consumer	مصرفی مہنگا خریدار استعمال کرنے والا
bounce	بھرنا پھردھاکہ چٹخا پھست
december	دسمبر
73.4	موقعیت
67.4	معدوم
previous	پیشاب پچھلی کچھ پہلے
preliminary	تہ لیہ مقدماتی پیشلی
estimate	تھکتا
michigan	میشیگان
university	ادارہ
two-month	دو مہینے
high	لی عہ اچ زیادہ
euro	یورو
downward	نارنگے جھک نہیں دعا پہ
sector	فہرست
sensitive	مستقل حساس حشرت مذبوح
situation	موقعیت موقف صورتحال
explain	توض
owen	ون
fitzpatrick	فیتزپاتھک
deutsche	عا
bank	بنک
security	فظ
ground	مردا باد زمین ہمارے
10-year	تیرہ سال
bond	رابطہ
yield	کشی فروت ادا یگی فراخ تسلیم
grow	رستےدار بڑھنا ترقی
3.54	فہرست معدوم معدول معدولہ
3.482	عدد
evening	ایوننگ
30-year	عشرے ری عشرہ پندرہ
4.497	چوتھی چار چارواں
4.492	چوتھی چار
oil	زیتون ہیرا گھنیلا
ministry	وزارت
reach	پہنچنا وصول
foreign	فارین
oil_company	کپلاس کمپنی
concern	خیال نگرانی قلق
violence	ہتھیابی قتل شکن ترسیم فا
instability	لاپسی بےثبات بےکنرو بےروزگار
attract	جذب راغب کھینچنا
rebuild	دوبنا بازبننا تجدید کرنا
ailing	مرضی خستہ ہنگامہ خونچک لا
infrastructure	تعلقت بنیادی ڈھاندی
auction	مزید کا
conclude	ختم نہیں
suggest	پیشکش کرنا پیشن اد
russia	روسیا
poise	تپاک نضبط وفایاداری اعتدال
refurbish	تجدید کرنا نرم است
oil_industry	لی ناعت
cripple	یلا کھا معذور لاپروری زار
decade	دہا
war	جہاد
sanction	تخلیق بند کرنا جنا یت ممانعت
company	مرکزی مجموعہ کمپنی
walk	امشی چل کرے رو
field	فیلڈ
seven	فوری سات
participate	ارک رن
submit	توقع تسلیم پیشکش
meager	مچکا محدود کمزور فقیر
representation	تعبیر نمایاں تصویر
giant	لہذا
open	فتح کھ راستہ صحن
surprise	تکلیف دلچسپ حیرت شگفتی دل
door	دروازہ
instead	بدج
you	تم تو
asian	تخلیقی مختصر مختصری
way	فراعت روشنی راہ راہگذر مس
ruba	روبا
husarus	ہزاروں
forum	فاروم
online	لا
news	نیاخبار نگامہ خبر تبلیغات
outlet	فروشی چڑھ خارجہ
long_time	دل دگ یہ ور ہوا
anything	کچھ ہر کو جیسا
offer	فرصت پیشکش عرض عرضہ پیش کردہ
underscore	تھکانا تلاش تکمیل
massive	اشر بڑا
coordinate	کو
bombing	بمبنگ
military	سلاح
withdraw	خلا کدھارا کدھ
likely	احتمال امکان وجہ
venture	تھکاوٹ سفر خطرہ امکان
forcefully	فورسفولی
third-largest	تہا سب سے بڑا
proven	تکثیب ثابت محکوم
crude	ہوکا دبود بےادب بےح
reserve	محفوظ حصہ احتیاط بچانا محس
particularly	فرکی طور پر
control	کن
energy	زخم تکمیل تلاش
markedly	شک اش
lower	سفید سادہ دلکش خوشنما
labor	لاوار سف کوشش شگری
prone	ہونے پرہمل خستہ سانی
risk	تھک خطر معانا خطرناک
shareholder	سہامدار
exxon-mobil	ود دوست فارسی
occidental	فارسی
petroleum	پٹرولیم
inc.	تکلیف بحران مصیبت غم خطرہ
chevron	چڑھا چمک چوٹی چور
conocophillip	خالص
cultivate	تھکا پن سوساویت ترقی توس
technical	تکنیکی
advice	نصیحت توجیہ مشورہ تکمیل
recent	تازہ
empty-handed	خالی
russian	روسیا
lukoil	لوکویل
gazprom	ام
stakeholder	مشار دار
contract	مفاہم قرارداد اتفاق مسود
award	جا زہ تقدیر شرف مقام تقدیم
weekend	تھکاوٹ ہوکا
national	قومی ملکی وطنی
corporation	فعل ہنگامہوار سسہ شر
large	لڑ بڑا
track	تراک
technological	تکنو لوجی
power	تھکاوٹ قوت حکومت
spokesman	تعبیر ناطق ممث
assam	سام
feel	احساس جیسا مذہول مفلوض مست
confident	تکتے خوبصورت مطم رازداری
par	پار
deliver	تلاوت کرنا پہنچانا
commitment	کلمت قسمت
towards	تھکاں کہاں نحو
pre-selected	پیش کردہ منتخب تیار
then	تھا تو پھر
per	مرتب
barrel	توبہ کوتھ کٹھی پال کچی
fee	یہ
above	فوق سے اوپر
us	اس وہ یہ
repay	مرتبہ بازگشت ترمیم تعو اد
crisis-hit	مصیبت زدہ محدودیت خطر
break	وٹنا لاشی
free	زاد مفت خوش
shackle	ہتھیالہ بند سلک
amount	محاسبہ مبالغہ تعداد مقدار
report	رپورٹ تا تبلیغات تبلیغ
cnbc	تکنیب
citigroup	مرکزی بینک سیکٹر عال
institution	مرکزی
want	چاہت کوچک تمنا
wiggle	جھنجھانا ہلانا جھومنا ہلچل
restriction	حد بندی محدودیت حظر
hand-in-hand	ہمکنش ایک اچ
acceptance	پذیر قابل قبول مقبول
limit	محدودیت
bonus	فا دہ جزا اضافہ مزید
raise	تھاڑھاڑ
investor	فا دہ کرنے والا
convertible	تبدیل قابل
rest	تلاش سکون راحت استراحت ٹھیک ہونا
own	خود ملک ذات حصہ شخص موجود
kitty	مختلی
fill	تکمیل پرہونہونہ منفذ
business	تجارت کاروبار عمارت
unit	تکایا تہا حصہ ایک
kenneth	کنیٹھ
lewi	لےوی
extend	توسیع کامل استقامی تمدید گے
express	تعبیر اظہار بیان
taxpayer	فرض گزار حصلہ ادا کرنے والا تعمیراتی رقم دینے
cash	نیا پیسہ جاری نقد
injection	تھیں حق دعا نہیں بڑھایا تکمیل
difficult	ٹھ شم
overstretch	تھکاوٹ ور استراحت
height	تھو
crisis	فقدان مصیبت خطر
investment	فا دہ تکلیف نفقات حصلہ وقفہ
merrill	مرادل
lynch	لعنت
capital	کپ
liability	مس ولیتی
thursday	ھفتھ
able	قدرت مہارت صلاحیت قادر ایقتدار
announce	اعلان اجلا اعلام
20	دو عشرہ
reference	مرجوعی استشہاد مذ
decline	نقصان افتادگی کمیاب زوال
goldman	گولڈن
sach	سچ
morgan	مورگن
chase	بھرپ دھون پیدا
stanley	اسٹینلی
cheshire	تلاش تلاشیں تلاشوں
appeal	فریب فریبانہ جذب کرنا
twitter	ٹر
there	ہاں یہ یہاں
half_a_dozen	تیرہ چھ سدھ
courtroom	کالج روم
send	جیسا
gruesome	ہولناک برا ترسناک خونخوار مرو
testimony	تہذیب ادت گواہی
140,000	فوریان
message	مرسلہ رسالہ رس
trial	تلاش امتحان مس لہ زما
rape	رپے
bed	تخت
house	غارا خانہ درخسان مخمل
set	تھا تسمیہ تلاش تکمیل تخلیق
ablaze	تھے جلتے
widely	فروانہ ویسے بیسے سرسیدگی
follow	فولو
steven	سٹیوین
j.	جوش
convict	فریب توبہ تکذیب
kill	مرد کوہل ہلاک جان فرو
conn.	کون کونہ کونے کونشمند
family	عمران خاندان قربانی
judge	عدالتی فتوی نفرت قاضی نظارت
imposition	فرض برداشت استیضاح اعلان
death	مرتضی وفات جانشیں فنا
sentence	فتحو کہانہ بات اظہار معانی جملہ
vote	واز دینا
jury	ری
mr.	مرکزی
filing	فا لنگ
sketch	رسم خطاطی نقاشی تصویر
argument	جھنگ تکلیف نزاع جدل مطالبہ اعتراض
occupy	شغل برقرار رہا تسلط حکومت
provocative	تخلیقی محر
intense	تکثیف شدت
mainstream	فروانہ مقبول سادہ عام
reporter	عدالت صحافی خبرنگار
extensive	توسیع
use	استعمال
create	بنانا ترقی ترم ترکانہ
circus	فارسی یروز رول
atmosphere	موسم
widespread	فرو پرا
instant	جذباتی فوری مضبوط
saturation	سیختگی
inflammatory	تھکانا
detail	تض تفصیل وضوح
improperly	تخریب شد ناصحیح بے قاعدہ
sway	تھاڑ جھ ہلانا
public	امانتدار لوگ عام
passion	دلچسپ عشق تڑپ شور تپاک
force	فورس زور قوت
grapple	گرفتار
experience	تجربہ
danger	خطر سکوورٹی سمپرانی فت یہاں
inclusion	فصلت جڑت مشتمل سم
fair-trial	عدالت سمعت
right	حق صحیح درست سچ
ullmann	مان
trial_judge	تلاش عدالتی
jon	جون
c.	علاج تسکین درد
blue	لا
tersely	راستہ
ruling	راج حکومت سیاست حاکم
carefully	سے احتیاط
controlled	قاب
evidence	دلا
drive	سوق سفر ساری سفرت
last_word	خرہ کا لمہ
appeals_court	فتوی کے درجے
recognize	جان پہچان پہچانی شناخت
coverage	تغطیہ پوشش
notorious	نوشاد نامور بگاڑ مش ور
can	کر تا پاتا
fairness	عدالت توازن نیکی انسانیت
landmark	مرکزی محل علامت مخاطب
1966	تیرہ سو چھ
united_states_supreme_court	صدر علاوہتسپریم کورٹ
overturn	تسمیہ ہمارے دعا ہنسی
conviction	تکمیل قناعت اعتقاد ای
cleveland	کلیو لینڈ
dr.	دعا
sam	سام
sheppard	شیرپد
murder	لہ ہلاک فنا قتل
wife	بیو زوجہ سسرال خال زوج
decision	فصل نفی تصمیم امکان انتخاب
v.	وہ تو تم تیرے
maxwell	ماکس
carnival	تھاڑپڑا
crime	فعل
inspiration	یادبخش حوصلہ افزا
fugitive	فروغی فرار پناہ مفرط
review	نظرت معا نہ راج
half	ہل
century	صد
later	لے
intrigue	تھا مداخلت ہوس فریب غرض
necessary	ضروری
communicate	مر تبادل گفتگو بات ہلاکت اتصال
unimagine	تخیل نہ کر پانا
general	فہرست عام
reason	کامل وجہ معقول منطق
media	مر
high-profile	فخریہ نامور مرتبہ اعلی
donohue	تھوڑی سے نام
iii	مرکزی مستقل مختصر
stanford	سٹیفن ڈا
school	تعلیم اسکول ہوس
professor	استاذ
study	مرکزش تلاش علم یاد کتاب تہذیب
connecticut	وننیکٹیکٹ
death_penalty	مرتضیہ سزا عمر جلا تا
write	لکھنا
arbitrarily	اس بات میں حیرت انگیز درستگی
enforce	فرض تعمیل اجرا مطابق
idea	فکرمند فکر فکرانہ
communication	تکمیل ارتباط اجلاس
many	بہت زیادہ کثیر چوں اکثر
argue	تک جھگڑا نبرد اختلاف الگ افتاد
delay	تہذیب اجلاس معاشی معاند
execution	ہمارے اس عمل
example	مثال
may	مہینے دلچسپ حب ختصر
prejudice	جاہلانہ اقتدار بگاڑ بیسا
allow	سامحت مستطیح
test	تست
potential	اسک امکان فطرت
juror	جج سماعتدار محاکم
reaction	رجحان پاسخ واکنش
grisly	تعبہ لود تک خون
crime-scene	جنازہ محل
photograph	فٹوجراف تصویر عکس
selection	انتخاب انت خابی ھکا
horrify	شگفتی ہولنا دلگیر ناراضی
victim	ہدف شکیلا جانب ضحایتگار
jennifer	جنیفر
hawke-petit	ہوکا پتیت
48	دل دلکا دلاب
she	ہو اسے وہ اس
daughter	بیٹا
hayley	ھیلی
17	سبع عشرہ
michaelum	میکا یلم
11	دس
constitutionality	قانونیت قانونی
wrongly	تھکانا غلط نقصان
remove	ور
critical	فقدان اہم مختصر مذہب مستقل
verdict	نتا حکم اعتراض
unusual	تعبہ
direct	توجہ سخت مباشر
deliberate	تخلیص است توجہ نیت
effect	کیا ہے اثر نتا تبعات
draw	تھکنا ہراسا باد کرنا پہنچنا
interest	علاوہ فراخی رغبت
note	نوٹ
file	فا
discuss	مرکزشانا باتچھی تلاش گفتگو تبادلہ
election	انتخاب را مسابقہ اون
campaign	محاربی مہم ترمیم
united_states_senate	صدر علاوہت سینٹ
fan	فین
flame	تپکانا جھ
emotion	دل جگاں احساس فقد غضب خوف اداسی
daily	روٹین عادات معمول
camera	کیمرا
ever	ہر بھی
new_haven	ہیون
maybe	محاسب شاید بھی نہیں
statewide	صوبا ریاستہو
controversial	شکل ناق جیسا جنگل
interview	ملاقات تشریف ےت لاوسے
journalist	فتنچی
incendiary	شعل
slowly	کامیاب
luddite	فروغی
view	نظر
often	ٹھتے تے
social	اجتماعی
change	فرا تبدیلی تکلیف مبدل تغییر تک
adaptation	تعدیل تعد
press	فرسا
refer	مرجوع کرنا رجوور رجحان رجوع رجو رج
represent	تعبیر کریں نمایاں پیش
21st	فوری عشر
sport	کھیل بازی شوٹنگ کرکٹ گیندابازی
fraud	فراڈ
trick	تھکانا چال فریب
those	ہوا وہ ان تھے
ramo	رشتہ ارادہ قسمت نیت فکر
ajax	صفا نظافت سفید خالص نیکوکاری
demonstrate	نما کرنا پیش ظاہرہ پرا
wittiness	تعبیر چمک چابکی خرد خوش بیان
expulsion	خروج اب بےوقوفی
presumably	فرض کر کے
madrid	مدر
xabus	خوبصورت دلکش نکتا خوشنما جماندار دل
sergio	سرجیو
23rd	تین عشریں
champion	چیمپی
league	لیگ
ink	رنگ چسب
behavior	کوشش سلوکی رو
unsportsmanlike	کھیل غیر مناسب
uefa	یو ای ایف اے
few	کمی
deliberately	تخلیصانہ ےبنا کا مقصود
waste	کچرا کچا نادہ بے ہوج
card	کارت
fulfil	کامیابی ادا بنانا تحقق عمل
prescribed	تخلیقی توجیہ تکمیل توجہ
auxerre	کسےر
rid	ہلاکت سہانا سخت باہر
following	فالی
phase	فقد مرحلہ تکمیل
committee	کمیٹی
discipline	تعبیر سچی
trainer	مرشد مربی سکھانے والا
jose	جوسے
mourinho	مورینیو
different	فار مختلف متب
implied	توقع درکار نشان استنتاج
provocation	تخلیق تحریک زبان است
similar	شابہ مشابہ
circumstance	موقعیت شرا ات
practice	تخلیق زما سلو
football	فٹبال
extended	خوب طویل
ethos	ایثار وفاداری احترام
unwritten	تکلیفدار نوشتہ نقصان بےروش
debate	تکلیف جماورہ گفتگو پرہن مناظرہ
arise	جانا پھرنا
related	ارشتہ جڑا ہوا معاشی اتحاد
carry	تحمل بھرنا نشانہ انتقال
organization	تنظیم انسجام ہو
hymn	یادگاری شعر قر
presume	فرض کو
nobility	اح شرف
honor	احترام شرف کیریگی سمعت
fine	ٹھیک حسن حال
analogous	ان
act	رو
dramatization	دھاکا سازی
orchestrate	تاریکار تنظیم
apparently	فہیم ظاہرہ تبدیل نظر ظاہر
expanded	تکایا گیا پھیلایا
history	تار
histrionic	تھا بڑبڑ شوخ بلا
provoking	تخلیق تشویق تحریک
technician	تکنیشین
type	فرصت امکان نوع
prohibit	حظر لگانا بھرا منحصر کرنا منع تب
specifically	اصلاحی تفصیلی مختص خاص
contradict	تضاد مخالف باطل مض
principle	اصول قاعدہ توجہ مبد
these	یہ یہیں یہاں
commit	کیمت قسمت کاام جرم تکمیل
respectful	احترام وقار مروت احس
elude	لافی انی
sense	تکلیف فہم انتقاد استدلال
matter	مس لہ اسپک موقعیت
examine	تلاش
damage	دامہ فت خستہ وار
spirit	روح جذبہ تخلیق تکمیل
advantage	فا دہ مزیت افتاداد ترقی
physical	زی
integrity	قیق وفاداری
opposite	جھنگا تلوار مقابل
aspect	فردوس نشان تکمیل محدود
violent	جارح مضبوط شراش مخرب
another	فرصت ایک دوسرا دیگر
allude	تلاش اشارہ استنباط استیضاح استعارہ
fare-play	فرا پلی
lawbreaker	ماواڑہ
unjustly	عدوانہ ناانصاف ظلم
paradoxical	تضاد مبہم مضحک مستقیم
thing	شے عمل مرتبہ وجود
comply	مطاب انجام گے
normally	نرمالا
violation	تخریب ھی
secretly	موم نہ بتا خفا
evident	ظاہرات
thus	یہ اس طرح یہاں لیے
receive	ھنا پہنچنا پاسا پہ
punishment	کیسہ سزا دعاوا
wait	کاوٹ درست جانت تھکاوٹ
accept	اکسپٹ
complaint	تکلیف شکایت عارض احتجاج مزید ناراض
violator	تخریبکار متار فاسد خا فاس
nor	نہیں
benefit	فایڈہ فایدا کمال
evidently	ظاہر واضح
result	نتا نتیجہ
suppose	فرض کریں کو معاش تھوکہ
less	کمی کثرت کم زیادہ
useful	فایدمند مہماںدار ضروری
strategy	استرات تکتیکی ہموار
count	مر
obviously	ظاہرات
consist	فعل رکھنا
championship	چیمپین شپ
threaten	خوجدھار مبارز محدود ترہیل
participation	مشار شار کت
certain	قیق قطع یقین جان مش
degree	ادارہ ڈگری درجہ
indetermination	تعدیموقعیت بےقیدگی عدم قطعیت
eliminate	ختم کرنا دور
addition	تکمیل اضاف جمع زیادہ
cycle	فہرست سیکل
suspension	تھکاوٹ معطل وقفہ
place	مکان مقام جگ
round	گرد دا رہ گول ہموار
really	واقعی صحیح سچا
strategic	تکتعیلی استراتیژیک
regard	احترام اعتراف تقدیر
assumption	فرض استنباط توقع استقراء تک
order	مرتب سیاست درست رڈر ترتیب
application	استعمال استدلال است استخدا
obey	اتباع خوشنود
border	حدایتار چغرا سد چوٹی
diffuse	فرو پخش تلاش پاش
occasion	تکلیف موقعیت مناسبت
controversy	سی سیا
factor	فیکٹر
auto	خودکار
transmission	تکمیل پھیلا پہ
directive	مرکزی ہدایت دستور امرسال
aesthetic	جما یش چوپک خوشگوار سلیقہ
arsenic-tolerant	رسینک برداشت کرنے والا
microbe	میکروب
possibility	امکان فرصت احتمال
life	زندگ جان وجود
earth	زمین
elsewhere	جا یں کہاں دور کوا
discovery	فرا کشف پیدا
strange	فری اکہ غریب مغرور مستقل مف
bacterium	باکتریہ
arsenic	رسینک
scope	اطوار حسب دامن
find	ملنا پیدا دور جانا تخلیق
form	فرم
possibly	محاسبا شاید مذید مم
beyond	بہ ند
researcher	محقق استاد
discover	فرو پیدا کرنا
element	اصلی مادہ جزء حصہ بخش
consider	فکر کرنا
essential	ضروری مطلوب سان موجود حیاتی
organism	مادہ موجود مخ
capability	قدرت ایقتدار استطاعت مصدا
phosphorus	فسفر
peculiar	مختزل
truly	سچ حقیقی
alien	مختلف
paul	پاول
w.	خوشامد
arizona	را زونا
co-author	فہرست کاربن
appear	ظاہر نظر دلچسپ
journal	مر
science	علوم تعل مطال عہ دانش معلومات
hydrogen	ہا ڈروجن
nitrogen	تر
oxygen	زخم خون ہوا دل
sulfur	سولفر
mono	منو
calif.	عالم نظام حکومت امیر سلطان
substitute	کن
wonder	عجب دل چور ناراضگی دلکش
ariel	فریڈ
d.	دعا درد دل
anbar	سبز خضاب ہرے
search	تلاش کریں فکر
look	دیکھنا نگاہ نظر مشا
announcement	اعلان نشان اعلام تبلیغات اع
disclose	فاش کرنا اعلان اظہار
generate	تولید کریں جاری
extraterrestrial	خارجی ست
planetary	مرکزی سیارہ فضاو نظام مجرا
biochemistry	تکمیلاتی علمی دانش
absolutely	مکمل سخت مطلق مستقل
cockell	کاکل
space	فضا خلاء مساحت درختستان
research	تلاش استقصا مطالع استہ
institute	انسٹی ٹیوٹ
open_university	زادانہ جامعہ
milton	میلٹن
keyne	ینے
united_kingdom	یونا یٹڈکنگڈم
novel	کہانی نیا روایت
substitution	تبدیل استبدال استحلال
fundamental	دمنتال
biochemical	بیوکییمیکل
structure	ساختمان مبنی تکیہ
chance	فرصت
felisa	فلیسا
nasa	نسا
astrobiology	تھکابین کاعلمیت
target	تارگٹ
speculate	تخمید لگانا کوہلنی توجہ توقع توج
expose	فاش کرنا نکالا اظہار پیشکش
mainly	مہینے
chemical	رجحان مادہ مخلوط مخلوص مستقل
hard_time	تعبہ مشکل کشمکش غرب
tell	بولنا کہنا بات خبر
apart	فارقت مفارقت فارغ
gum	گوم
machinery	مکانیں
collect	جمع کرنا
gfaj-1	فاج
concentration	تکمیل مرکزی ایک
live	زندگی جینا زندگ زندہ
life_form	زندگی شکل
occur	توحید تکمیل تلاش تخلیق
naturally	فطرت سے
common	کومن
s.	سہولت سہسام
foster	فارماس فاروری
microbiology	میکروبیالوجی
florida	لور ڈا
never	کبھی نہیں
department_of_energy	ادار توانا
national_institutes_of_health	ملکیت نیشنل ایفایسٹس اوفر
democratic	جمہوری
routine	روت
democracy	جمہوریت
latin_america	امریکہ جنوبی
bigger	بڑا لڑکا بگڑا
worry	نگرانی قلق جھن ترد
unemployment	بے روزگاری
brazil	برازیل
across	لاشتہ اس
region	تہیں قریہ خانہ دریا مقام
latest	خرین تازہ
latinobar��metro	لمیںٹرومتر
poll	با انتخاب مخاطب
18	اسٹھاس
publish	بنا شر
exclusively	خالصتا فقط حصرا بیکھیری
economist	اقتصادی ماہر
regularly	ریا روٹین معین
attitude	عدالت تعبت تکبر تکریم تخلق
october	اکتوبر
fairly	فارہی
sunny	تاریکی شمس خیر
mood	دل جگ
core	دل مرکز جوڑ تک
several	فہرستیں
table	جاول
peru	تھا تپش تپت تپنا
economic_growth	اقتصادی رشد
6	چھ
low	لوا دعا کیسا کمزور خام
2005	تیرہ سو پانچ
61	شام
suffer	تکلیف بیماری معاناہ جزی ناراض
around	حول پرے دےر چور پھیر پیر
respondent	جاوبہ دینے والا
convinced	قناعت یقین مطم
drag	ہراسا بھاگنا تکمیل باہر
pronounce	اردو کہلوانا بیان کرنا اظہار
satisfy	اطمینان رسانی کرنا رضاکردار بودن
34	دل دلکا دلاب
congress	تریبون مجلس انتظامیہ
sharply	تیز بنا
24	فوری
respectively	فرصت امکان استطاعت توجہ معاش
undermine	تضعیف ترک زلزلہ
probably	احتمال شاید
latin	فہرست
brief	مختصر کوتاہ تیز
recession	رکاوٹ معاشی کامیابی
enjoy	مصیبت دلچسپ تفریح دلکش خوشی دل
strong	جڑواں قوی زوردار
stronger	تار قو
safety_net	تکلیفیں تخفیفیں سپرنگ سکیورٹی
shield	بھاڑو پناں حفاظت
united_nations	اتحاد عالمی
economic_commission_for_latin_america	فا دہ کے امریکی کمیشن
proportion	توازن نسبت انداز حصہ
poverty	فقرت
marginally	محدودانہ
2009	تیرہ ٹھ دس بارہ سبع
32	دل دلکا دلاب
-rrb-	مرتب قابل متعلق مستند
vary	تغیر مختلف متفاوت
4	چار
popularity	مش وریت شہرت نامور
outgoing	خارج نکلنے والا
president	صدر یس قا سربراہ
luiz	لو یس
in��cio	شروع ابتدا
da	دہ
silva	تلافی تلاش
reflect	انعکاس بازتاب پشمار تص
share	شیر شکریاں شریف شراب
progress	تک
scarcer	کمزور مفقود نادر
severe	ار سخت دلدل شدید
whole	کامل سختہ مختصر مجموع
problem	مس لہ
5	پانچ
31	ایک دس
relative	مرحوم واسط نسب خاندانی
lowest	لوٹھیلا سبزہ دعا
robust	قو قوی
market_economy	مرکزی اقتصادی
71	سبع عشرہ
indispensable	ضروری اہم جزی مطلوب حصیر
development	تک وادی تکروزوادی
56	امکان ممکن
58	جنب
agree	مطابقت تفقہ سختہ موافقت
system	نظام سیستم
47	دل دلکا دلاب
interestingly	ری ہوم
venezuela	ویکیبڈیا
80	مرکزی
left-wing	لڑکا
ch��vez	چابزہ
expropriate	تسمیہ استحصال استیصال است
private	نظری حصہ محفوظ
exercise	تمر کام نشاط روٹین
leadership	رہنما
9	نوے
unchanged	تبدیل نہیں ہوا
distinction	فارقی مفہوم متمایہ
dominican_republic	جمہوریہ ڈومینیکن
scalium	کالج
healthcare	تخفیف تک صحت
challenger	چیلنجر
gather	جمع کرنا
behind	خلاف پیچھے پشت
divisive	مفلوض
justice	عدالت
antonin	نتونین
clarence	عرینس
dinner	رواں کھانا راواں کھانے
sponsor	فنڈر مولی ڈانر حمای
law_firm	لا کے حملہ
nine	تین
meet	ملنا
pour	تھا بہا پہنچا کرنا پری
petition	تکمیل نماز درخواست عرضہ
suit	لباس پہننےوالاکے جملہ
26	چھاونے
sweeping	نگ
overhaul	تعدیل تصفیہ تجدید استحداث
rallying_cry	مرکزی بکری
conservative	متحفظہ
nationwide	مرکزی قوم ملکوار
5.5	عدد
march	مرچے
outcome	نتا
further	مزید سے گے
roil	تلاطم اضطراب خلل بکھ
2012	تیرہ دو ہزار
full	کامل شک شتمل
swing	تھاڑ تکانا لکھا دوبارہ
throw	تھاڑ پھینکنا کٹادیں
clement	مہتاب نرم خوش نعم
george	جارجیا
bush	مراما
bancroft	بن کرافت
pllc	پالیسی لیبل لا سنس
annual	سالانہ
federalist	فیدرلست
society	مجتمع سماجی امارت اتحاد انسانی
dedicate	تع وفاداری
trade	تجارتی تجارت تجوہ
association	اسوسیشن رابطہ معاہدہ اتحاد ات
independent	زاد خودگرد خودبس مستقل
pfizer	فایزر
inc	تکلیف مشکل غبار حشر مصیبت
enormous	بہاریں بڑا سخت بگڑا
litigation	لگانا چارہ داری داد توسہ
hotel	ہوٹل
attendance	موجودیت درجہ حاضری نوکری
among	مرے درمیان
mitch	مچ
mcconnell	مکنل
senate	مرکزی سناٹے مجلس
republican	جمہوری
avowed	محاک مہ
featured	فتا نمونہ اعلی مش ور
guest	مہمان
attend	حاضرہونا شرکتکرنا حاضررہنا
event	ایونت موقعیت کاربرد اتفاق
afoul	تھا خطرہ خلاف مخالف مخالفہ
ethic	نیک حسیں سچی خوب
exempt	خاتم مستثنی
arguably	تعلیک مذہب مستقل
under	تلے
code	کوڈ
canon	فہرست
4c	تکلیف غم اداسی ناراضی دلگیر
fund-raising	فنڈ ری
law-related	قانون سے متعلقہ
speaker	لبھان مذکر
guest_of_honor	مرحوم مہمان اعزاز
program	مرکزی برنامج پرگرام
proximity	قریبگی
alarm	تنبہ احتیاط
breach	انہ
indifference	بے پرواہی بنابالا ناراضی
belie	فکرا تبدیل
bob	اب
edgar	اڈگار
wine	یقین شربت
black-tie	سیاہ پوش
fundraiser	تکمیل کرنے والے ملاوٹ جمع وقفہ بندو
pend	پند نبرد
appearance	ظاہرات نمونہ دعاوت مظ رنگ
fundraise	تاسیس کرنا کمپنی جاری
undercut	تختہ خرا تخفیف زیر قیمت
impartiality	توازن عدالت بی طرفی
unacceptable	غیر قابل قبول ناقابل
little	اصغر چھوٹی کوچک بیڑھی
critic	تخہن نقدگر
too	بہت کثرت زیادہ چوں
readily	تیارگی سختگی سخت سختہ
mix	مختلط
agenda-driven	مفتی درخور
ginnus	تک
elena	ای
kagan	کاجان
recuse	توبہ تکلیف تک
herself	خود خودگار خودی خودپسند خودنصیب
invest	میں نظام
indication	نشانی نشانہ خبر
familiarity	فہیم اعتیاد اع
spanish	فہرست
higher	لی تر زیادہ چی بال
tico	تکلا
22	خوش دل
call	مرک
spain	ایسپین
ten	تین
side	لا کنار
costa_rica	کوسٹا ریکا
minor	وٹی ونیا کچھ کم
contrast	تضاد
friendly	دا ربان
3:05	بجے
pm	پھر موجود موجودہ موجودگی
stadium	مرکزی میدان
san_jose	مرکز شہر پرتکاب مخت
europe	یورپ
number_one	ایک عدد پہلی سب سے اہم
monthly	فارسی مہینے
record	ریکارڈ
class	مرتبہ درجہ گروپ شعب
inter	تار دروازہ مداخلت اتصال
tricolor	تخت رنگی
umana	امانا
number	عدد کو حاصل شمار تعداد رقم
panama	پانا مہا
0-2	امکان نہیں
rommel	رمحل
fernandez	فردینیز
all-star	ستارہ خوشگوار اہم
powerful	تھکاں قوت طاقت زور
premier	مرکزی اہم اعلی ریاست
england	انگلینڈ
active	حر داہ
competition	تکاوت مسابقہ شرافت در
shock	شوک
fury	غضب احسان تعجب استیغلال
complicated	تعبہ محروم مبہم غلط کٹھن
qualification	تخصص درجہ صلاحیت سوابق
world_cup	جامعیت عالمی
limited	محدود
area	اس در خال محل مسا
concacaf	تھکاوٹ سختگی محدودیت محدود
peak	چوٹی تیز
goalkeeper	محفوظ ڑھ
iker	ایکر
0-1	تکالی
london	لنڈن
equal	مساو
ex	خوشی
zubizarreta	زوبیزارتہ
match	مچ مچھی مچا مچکا
impose	فرض کرنا لایا لطف
127	ایکصد
xavus	خاموش سکوت سہرا سپر
hernandez	ہارنز
barcelona	بارسلونا
106	جنب
iberian	یوربیان
striker	ضرب کرنے والا
gonzalez	فہرست الگزانز
102	تاسع عشر
centennial	مرکزی سال صدسالہ تاریخی
carle	کرم
puyol	فرخ پےول
left-lateral	لڑا سمو چپو با دا یں
diaz	دعا جزا فضل نعمت
bryan	بر ان
five	فا یو
exceed	تجاوز تعدی تخم
keilor	یور
nava	نواں
randall	رینڈل
azofeifa	زوفا یفا
barrante	فارسی
36	دل دلکا دلاب
lui	لو
lopez	لوپز
35	فو
gerard	جرد
piqu��	پشینگی پش
37	چوہدری
busquet	بوس
santiago	سیاچو
santus	السلام
cazorlum	کا
alvaro	الوارو
albiol	مرکب سفید بیلی سا
presence	موجودگی وجود حاضری
miller	ملر
winston	وا سٹون
park	پارک
gabriel	قابیل
badillum	بہتر
23	عدد
nacho	نچنا
moreal	کامل سخت سختہ مخت
victor	فتح جیت شیر شہرا
bolivar	ادارہ تالا ملا ملازم
olman	لمان
varga	مرتبہ
nelson	نلسن
edder	ان نارمح
debut	نمایاں شدن
yet	یاد تو ہاں اس کاش
fernando	فرینڈو
27	سبع
rica	کا
register	رہی تالا دروازہ دکان
immigration	انتقال ہجرت
opportunity	تکلیف فرصت امکان
nicola	نیکولا
sarkozy	فرانس
criticise	تخریب کرنا نقد شکایت
various	اختلفی
congestion	تھکاوٹ حشرت جمع
police	فرانسیسی
compatibility	ہم ہی
self-proclaimed	فرض کردہ خود
status	حالت وضع درجہ
french	فرانس
recently	تازہ ہو رہا
harassment	ہراسا عبارت اقتدار تباہی متا
student	طلبہ طالب
topical	تاریک تکلیف موضوع محل
interior	داخل درون با
declare	قطع اعلان نبذا نشان بیان
france	فرانس
talent	قابلیت
bricklayer	لب ور سیمنٹ ڈالنے والا
analyze	تحلیل
viewpoint	دیدگاہ نظریہ فلسفہ را یت
consensus	تفقہ ایجماع ہوموش
left	لے کھی پھاڑ پاہٹ
jacque	دیم
chirac	چیراک
1976	تیرہ سو
900,000	فوریان
unemployed	عدم نوکری
worker	لاوکار
rocard	رکھا کرنا کروا کرایا کر
misery	دلگیر غم تکلیف اداسی
difference	فار
fear	خوف ڈر ترس ہراسا تردد
invasion	فتح فروغ غزو استیلا حمل
territory	تھکنہ محدہ بلد
horde	ہجوم
polish	پالش
plumber	پلمبر
immigrant	اجرت کرنے والا یا
reside	رہا مقیم اسکان مستوطن
deign	تخفیف احترام اعتنا
fran��ois	فرانسیسی
hollande	فرانس
confines	محدود محدودیت سیا
himself	خود اسے
banality	ہولہ ولہ سلیپر سادگی بےرو
co-development	تکمیل پرستی تک
solve	حل کریں
notion	تصو
electoral	انتخابات حصہدار منتصب انتظامی
economically	اقتصادی
costly	قیمت دار مہنگا خستہ
ian	ایان
knowledge	علم دانش معلومات دانشگاہ علمی اط
exceptional	مطلوب
migration	انتقال ہجرت مسافرانہ کوچ اسکان
shaped	شکل ہندسہ تختہ مخ
our	مرے ہم
define	تعریف
mai	مای
2011	تیرہ
princeton	پرنسٹن
pp	تکلیف مشکل غبار خطرہ
wide	فرو عر
specialist	فہرست
positive	جذب مثبت متعجب راضی
flow	فضا چلاج رواں جاری
wage	مرتبہ تعوین حاصل در مد
employment	روزگار استعمال خدمت شغل
admit	قبول کریں جیسے اعتراف
anaemic	انیمیا چڑچڑاہٹ
growth	رشد تکمیل جذب پرورش
harm	کیسے
base	مرکیز مبنی پایہ بلند
liable	مہذ اں قابل مس ول
replace	غی تاسیس استبدال تب
unskilled	مخت ناخ غیرمتخصص بےروش نہ غیرق
exert	تلاش کریں
reality	رہی حقیقت
complementary	تی تکمیل تکامیلی مبارک
replacement	توقع تبدیل استبدال استحکام استیع
shortage	کووں کمبود نقصان کمزوری
highly	علیحدہ
skilled	ارتدار صلاحیتدار براہ مندرجہ
dynamic	تک ام لیفی
training	تخلیق مادگی پرورش سکھانا
link	رابطہ جڑ اتصال
surgeon	جراح
complementarity	تکمیل توازن انسجام
exist	وجود برقرار استوار
arrival	احرا
perus	مرکزی
calculate	حساب کرنا
migratory	اجرت کرنے والا
0,6	تیرہ ست چار پچیس
0,9	تیرہ
long-term	ہو دوری استقامی
account	حساب را حسابدار حسابیں
diversity	تعدد تنوع مختلف متعدد
creation	خلق وجود فریں
naturalised	وطنو سازی
nobel_prize	نوبل
winner	جانجانہ جیتکار فا شریف قا
whilst	فرصت ہنگامی دیکھیں جیسا جبکہ
google	کچھ
paypal	فیسپےل
ebay	ایبی ای بی
yahoo	یارو ہا
found	فرا پا پیدا کی تخلیق
migrant	اجرت کرنے والا
contributor	اع اہ
total	حص کل
budget	تکنیکی تقعیب
organisation	تو ساز
age	جنسیت سن عمر
receipt	رکھنا قبول تصدیق استلام
150,000	فوریان
lifetime	زندگی موت سمان خوشبو
wish	تمنا رزو درخواست
mandate	ممنوعیت ہدایت فرض ہدایات ہدایتنامہ
miss	مصیب فقد
tooth	دانت
multi-million	فلو ملین اربین ارب دیکر
pound	پا نڈ
usa	امریکہ
trouble	مشکل مس لہ غلطی کونش
hard	قیق سخت کٹھن سختگراں
heel	تکانا
uproar	تھا
josef	جوزف
ackermann	تکمیل نہیں
ceo	مرکزی ہدایت کنند
industry	تکنو صنایع کارخانے
catch	پکڑنا جاتی لانا
frankfurt-based	فراں کف رت بر دار
145	عدد
settle	تثبیت استقرار سادگی
dispute	تکلیف جھگڑا اختلاف نزاع
bankruptcy	بنوک رپٹی
credit_union	یونین
centre	مرکز
credit	احترام تکریم اعتماد فضل جزا شکر
union	اتحاد
ncua	تکایا
regulator	منظم کرنے والا
accuse	جواب شکایت کا ات ام فریب
string	تھاڑی تھاڑوں تھاڑیوں
FALSE	فالس
buy	خریدنا خریدا حاصل کرنا
product	فروخت محصول پروڈکٹ
value	مرکزش اہمیت قدرت
dramatically	تادم بڑی طرح میں
happy	عاشتیاور خوشحال مختل شاد مبخلی
party	تھا منفعل جشن ملاقات
new_york	نیا
culpability	تکلیف مس ولیت
settlement	فتحت استقرار محل بادگاری
chairman	صدر کمیٹی چی رمین
debbie	دببی
matz	ماتز
welcome	سودہ
responsible	مس ولیت
intervene	کرنا
customer	فا دہ طلبگار گاہک
deposit	تخلیق جمع
approach	فضا کرنا نزدیک ہونا پہنچنا
scotland	اسکاٹلینڈ
summer	یادگار
so-called	ہمی جیسا
mortgage-backed_security	مورتگے بک شد سیکریورٹی
seal	سیاہی ختم چہرہ
fate	نصیب قدرت
bubble	لا
explode	انفجار جھڑتا پھاڑ بکھرا
lehman	لیمن
brother	بھا
belly-up	بلے سے دیر
2008	تیرہ سو ٹھ
wind	فضا ھیوا ھیو
vast	بہا
punish	کارتاب سزا توبیخ دعاوت
housing	رہا اکا نٹ مقام سکن مشمول
finance	فنانس
largest	لڑاکا
wave	دیدہ چال موج امواج تلاطم
lender	فریقہ مہملہ موقوف
fannie_mae	فانی می
freddie_mac	فریدے مک
transaction	تراکنش
200	فوری
cover	ور چوری پوش سپر سار
multiple	چوڑا طول تعدد
14.2	ربعاس پچیس
responsibility	مس ولیت
substantial	مضبوط اہم کثیر متعدد
specify	تعبیر کریں تخصیص حص تعیین تف
exact	قی مشابہت
sum	تکلیف محاسبہ حساب مجموعہ
baseless	بے اساس
intention	نچ
fend	فند
